{
    "tiles": [
        [0, 0, 0, 0, 0, 0, 0, 0, 0, 0, 0, 0, 0, 0],
        [0, 0, 0, 0, 0, 0, 0, 0, 0, 0, 0, 0, 0, 0],
        [0, 0, 0, 0, 0, 0, 0, 3, 7, 7, 7, 7, 7, 10],
        [9, 7, 7, 7, 5, 0, 0, 8, 0, 0, 0, 0, 0, 0],
        [0, 0, 0, 0, 8, 11, 0, 8, 0, 0, 0, 0, 0, 0],
        [0, 0, 0, 0, 8, 11, 0, 8, 0, 0, 0, 0, 0, 0],
        [0, 0, 0, 0, 8, 11, 0, 8, 0, 0, 0, 0, 0, 0],
        [0, 0, 0, 0, 2, 7, 7, 4, 0, 0, 0, 0, 0, 0],
        [0, 0, 0, 0, 0, 0, 0, 0, 0, 0, 0, 0, 0, 0],
        [0, 0, 0, 0, 0, 0, 0, 0, 0, 0, 0, 0, 0, 0]
    ],
    "width" : 14,
    "height" : 10,
    "tilesize": 64
}