{
    "tiles": [
        [0, 0, 0, 0, 0, 0, 0, 0, 0, 0, 0, 0, 0, 0],
        [7, 7, 7, 7, 7, 7, 7, 7, 7, 5, 0, 0, 0, 0],
        [0, 0, 0, 0, 0, 0, 0, 0, 0, 2, 7, 7, 5, 0],
        [9, 7, 7, 7, 7, 5, 3, 7, 7, 7, 5, 0, 2, 7],
        [7, 5, 0, 0, 0, 8, 8, 0, 0, 0, 2, 7, 7, 10],
        [0, 2, 5, 0, 3, 4, 2, 5, 0, 0, 0, 3, 7, 7],
        [0, 0, 8, 0, 8, 0, 0, 8, 0, 0, 0, 8, 0, 0],
        [0, 0, 8, 0, 2, 7, 7, 4, 3, 7, 7, 6, 7, 7],
        [0, 0, 8, 0, 0, 0, 0, 0, 8, 0, 0, 8, 0, 0],
        [0, 0, 8, 0, 0, 0, 0, 0, 8, 0, 0, 8, 0, 0]
    ],
    "width" : 14,
    "height" : 10,
    "tilesize" : 64,
    "startx" : 0,
    "starty" : 3 
}