{
    "tiles": [
        [0, 0, 0, 0, 0, 0, 0, 0, 0, 0, 0, 0, 0, 0],
        [9, 7, 7, 7, 5, 0, 0, 0, 0, 0, 3, 7, 5, 0],
        [0, 0, 0, 0, 8, 0, 0, 0, 0, 3, 4, 0, 2, 10],
        [0, 0, 3, 7, 6, 7, 5, 0, 3, 4, 0, 0, 0, 0],
        [0, 0, 8, 0, 8, 0, 8, 0, 8, 0, 0, 3, 7, 5],
        [3, 7, 6, 7, 6, 7, 6, 7, 6, 7, 7, 4, 0, 8],
        [8, 0, 8, 0, 8, 0, 8, 0, 8, 0, 0, 0, 0, 8],
        [2, 7, 6, 7, 6, 7, 4, 0, 2, 7, 7, 7, 7, 4],
        [0, 0, 8, 0, 8, 0, 0, 0, 0, 0, 0, 0, 0, 0],
        [0, 0, 2, 7, 4, 0, 0, 0, 0, 0, 0, 0, 0, 0]
    ],
    "width" : 14,
    "height" : 10,
    "tilesize" : 64,
    "startx" : 0,
    "starty" : 1 
}