{
    "tiles": [
        [0, 0, 0, 0, 0, 0, 0, 0, 0, 0, 0, 0, 0, 0],
        [0, 0, 3, 5, 0, 0, 3, 5, 0, 0, 0, 0, 0, 0],
        [0, 0, 2, 4, 0, 0, 2, 4, 0, 0, 0, 3, 5, 0],
        [0, 0, 0, 0, 0, 0, 0, 0, 0, 0, 0, 2, 4, 0],
        [0, 3, 5, 0, 3, 5, 0, 0, 3, 5, 0, 0, 0, 0],
        [9, 6, 6, 7, 6, 6, 7, 7, 6, 6, 7, 7, 7, 10],
        [0, 2, 4, 0, 2, 4, 0, 0, 2, 4, 0, 0, 0, 0],
        [0, 0, 0, 0, 0, 0, 0, 0, 0, 0, 0, 3, 5, 0],
        [0, 0, 3, 5, 0, 0, 3, 5, 0, 0, 0, 2, 4, 0],
        [0, 0, 2, 4, 0, 0, 2, 4, 0, 0, 0, 0, 0, 0]
    ],
    "width" : 14,
    "height" : 10,
    "tilesize" : 64,
    "startx" : 0,
    "starty" : 5 
}